10 10
XXXXXXXXXX
X........X
X...X.R.XX
X........X
X......C.X
X........X
X....R.C.X
X........X
X........X
XXXXXXXXXX

10 10
XXXXXXXXXX
X........X
X...X.R.XX
X........X
X......C.X
X........X
X....R.C.X
X........X
X........X
XXXXXXXXXX

10 10
XXXXXXXXXX
X........X
X...X.R.XX
X........X
X......C.X
X........X
X....R.C.X
X........X
X........X
XXXXXXXXXX

10 10
XXXXXXXXXX
X........X
X...X.R.XX
X........X
X......C.X
X........X
X.....RC.X
X........X
X........X
XXXXXXXXXX

10 10
XXXXXXXXXX
X........X
X...X.R.XX
X........X
X......C.X
X........X
X......R.X
X........X
X........X
XXXXXXXXXX

10 10
XXXXXXXXXX
X........X
X...X.R.XX
X........X
X......C.X
X........X
X......R.X
X........X
X........X
XXXXXXXXXX

10 10
XXXXXXXXXX
X........X
X...X.R.XX
X........X
X......C.X
X........X
X......R.X
X........X
X........X
XXXXXXXXXX

10 10
XXXXXXXXXX
X........X
X...X.R.XX
X........X
X......C.X
X........X
X......R.X
X........X
X........X
XXXXXXXXXX

10 10
XXXXXXXXXX
X........X
X...X.R.XX
X........X
X......C.X
X......R.X
X........X
X........X
X........X
XXXXXXXXXX

10 10
XXXXXXXXXX
X........X
X...X.R.XX
X........X
X......R.X
X........X
X........X
X........X
X........X
XXXXXXXXXX

