10 10
XXXXXXXXXX
X........X
X....XRX.X
X........X
X........X
X........X
X..R.....X
X........X
X........X
XXXXXXXXXX
