20 20
XXXXXXXXXXXXXXXXXXXX
X..................X
X..................X
X..................X
X............R.....X
X..................X
X..................X
X..................X
X..................X
X..................X
X..................X
X..................X
X..................X
X....R.............X
X..................X
X..................X
X..................X
X..................X
X..................X
XXXXXXXXXXXXXXXXXXXX