20 20
XXXXXXXXXXXXXXXXXXXX
X..................X
X..................X
X..................X
X........X....R....X
X....C.............X
X..................X
X..................X
X........X.........X
X..................X
X........XX........X
X..................X
X........XX........X
X....R.............X
X..................X
X.............CC...X
X..................X
X..................X
X....C.............X
XXXXXXXXXXXXXXXXXXXX